ARM,	Arm
LIN,	Linde
AZN,	AstraZeneca
BKR,	Baker Hughes
AVGO,	Broadcom
BIIB,	Biogen
BKNG,	Booking Holdings
CDNS,	Cadence Design Systems
ADBE,	Adobe
CHTR,	Charter Communications
CPRT,	Copart
CSGP,	CoStar
CRWD,	CrowdStrike
CTAS,	Cintas
CSCO,	Cisco
CMCSA,	Comcast
COST,	Costco
CSX,	CSX
CTSH,	Cognizant Technology
DDOG,	Datadog
DXCM,	Dexcom
FANG,	Diamondback Energy
DLTR,	Dollar Tree
EA,	    Electronic Arts
ON,	    ON Semiconductor
EXC,	Exelon
TTD,	Trade Desk
FAST,	Fastenal
GFS,	GlobalFoundries
META,	Meta
FI,	    Fiserv
FTNT,	Fortinet
GILD,	Gilead Sciences
GOOG,	Alphabet
GOOGL,	Google
HON,	Honeywell
ILMN,	Illumina
INTC,	Intel
INTU,	Intuit
ISRG,	Intuitive Surgical
MRVL,	Marvell
IDXX,	IDEXX
KDP,	Keurig Dr Pepper
KLAC,	KLA
KHC,	Kraft Heinz
LRCX,	Lam Research
LULU,	Lululemon
MELI,	MercadoLibre
MAR,	Marriott
MCHP,	Microchip Technology
MDLZ,	Mondelez 
MRNA,	Moderna
MNST,	Monster Beverage
MSFT,	Microsoft
MU,	    Micron Technology
NFLX,	Netflix
GRAL,	Grail
NVDA,	NVIDIA
NXPI,	NXP Semiconductors
ODFL,	Old Dominion Freight Line
ORLY,	Oâ€™Reilly Automotive
PCAR,	Paccar
PANW,	Palo Alto Networks
PAYX,	Paychex
PDD,	PDD Holdings
PYPL,	PayPal
PEP,	PepsiCo 
QCOM,	Qualcomm
REGN,	Regeneron Pharmaceuticals Inc
ROST,	Ross Stores
SBUX,	Starbucks
SNPS,	Synopsys
TSLA,	Tesla
TXN,	Texas Instruments
TMUS,	T-Mobile US
VRSK,	Verisk Analytics
VRTX,	Vertex Pharmaceuticals
WBD,	Warner Bros Discovery
WDAY,	Workday
XEL,	Xcel Energy
ZS,	    Zscaler
ADP,	Automatic Data Processing
ABNB,	Airbnb
AMD,	AMD
CEG,    Constellation Energy
AMZN,	Amazon
AMGN,	Amgen
AEP,	American Electric Power Company
CDW,	CDW
CCEP,	Coca-Cola
ADI,	Analog Devices
MDB,	MongoDB
DASH,	DoorDash
ROP,	Roper Technologies
ANSS,	ANSYS
AAPL,	Apple
AMAT,	Applied Materials
GEHC,	GE Healthcare Technologies
ASML,	ASML Holding NV
TEAM,	Atlassian
ADSK,	Autodesk